111111111111111111111111111
10110000P0CE111111111111111
10000N000000111111111111111
111111111111111111111111111
111111111111111111111111111
111111111111111111111111111
111111111111111111111111111
111111111111111111111111111
111111111111111111111111111
111111111111111111111111111
111111111111111111111111111
