1111111111111
1001000000PC1
1NC0011111001
10C011E000C01
1111111111111
