1111111
1NP0101
1000001
100C001
100C001
100C001
100C001
100C001
100C001
100C001
100C001
100C001
100C001
100C001
100C0E1
1111111
