1111111111111111111111111111111
1E00000000N0000C00000C000000001
1010010100100100101001000010101
1010010010101010001001000010101
1P0000000C00C000000N000000000C1
1111111111111111111111111111111
